Spritesheet=grass
Height=12
Width=22
Tiles
14 11 11 11 11 11 11 11 11 11 11 11 11 11 11 11 11 11 11 11 11 13 
07 03 03 03 03 03 03 03 03 03 03 03 03 03 03 03 03 03 03 03 03 05 
07 03 03 03 03 03 03 03 03 03 03 03 03 03 03 03 03 03 03 03 03 05 
07 03 03 03 03 03 03 03 00 01 01 01 01 01 01 01 02 03 00 01 01 08 
07 03 03 03 03 03 03 03 05 14 11 11 11 11 11 13 07 03 10 11 11 13 
09 01 01 01 01 02 03 03 05 07 03 03 03 03 03 05 07 03 03 03 03 05 
14 11 11 11 13 07 03 03 05 07 03 03 03 03 03 05 07 03 03 03 03 05 
07 03 03 03 05 07 03 03 05 07 03 03 00 02 03 10 12 03 03 03 03 05 
07 03 00 01 08 07 03 03 05 07 03 03 05 07 03 03 03 03 00 01 01 08 
07 03 10 11 11 12 03 03 05 07 03 03 05 07 03 03 03 03 10 11 11 13 
07 03 03 03 03 03 03 03 05 07 03 03 05 07 03 03 03 03 03 03 03 05 
09 01 01 01 01 01 01 01 08 09 01 01 08 09 01 01 01 01 01 01 01 08 
