tileset grass_to_rock.png
width 20
height 10
13 10 10 10 10 10 10 10 10 10 10 10 10 10 10 10 10 10 10 12
06 03 03 03 03 03 03 03 03 03 03 03 03 03 03 03 03 03 03 04
06 03 03 03 03 03 03 03 03 03 03 03 03 03 03 03 03 03 03 04
06 03 03 03 03 03 03 03 00 01 02 03 03 03 03 03 03 03 03 04
06 03 03 03 03 03 03 03 04 05 06 03 03 03 03 03 03 03 03 04
06 03 03 03 03 03 03 03 09 10 11 03 03 03 03 03 03 03 03 04
06 03 03 03 03 03 03 03 03 03 03 03 03 03 03 03 03 03 03 04
06 03 03 03 03 03 03 03 03 03 03 03 03 03 03 03 03 03 03 04
06 03 03 03 03 03 03 03 03 03 03 03 03 03 03 03 03 03 03 04
08 01 01 01 01 01 01 01 01 01 01 01 01 01 01 01 01 01 01 07
