Spritesheet=grass
Width=15
Height=8
Aliases=╔╤╗░a╟▓╢┘└╚╧╝┐┌
Walkable=
Tiles
╔╤╤╤╗░╔╤╤╤╤╤╤╤╗
╟▓▓▓╢░╟▓▓▓▓▓▓▓╢
╟▓▓▓╢░╟▓▓┌╧┐▓▓╢
╟▓▓▓╢░╟▓▓╢░╟▓▓╢
╟▓▓▓╢░╟▓▓╢░╟▓▓╢
╟▓▓▓╢░╟▓▓└╤┘▓▓╢
╟▓▓▓╢░╟▓▓▓▓▓▓▓╢
╚╧╧╧╝░╚╧╧╧╧╧╧╧╝