Spritesheet=grass
Width=20
Height=10
Aliases=╔╤╗░a╟▓╢┘└╚╧╝┐┌
Walkable=
Tiles
┌╧╧╧╧╧▓╧╧╧╧╧╧╧╧╧╧╧╧┐
╢░░░░░▓░░░░░░░░░░░░╟
╢░░░░░▓░░░░▓▓▓▓▓▓░░╟
╢░░░▓░▓░░░░▓░░░░░░░╟
╢░░░░░▓░░░░▓░░░░▓▓▓▓
▓▓▓░▓░▓░░▓▓▓▓▓░░░░░╟
╢░░░▓░░░░▓░░░▓▓▓▓▓░╟
╢░░░▓░░░░▓░░░▓░░░░░╟
╢░░░▓░░░░▓░░░░░░░░░╟
└╤╤╤▓╤╤╤╤▓╤╤╤╤╤╤╤╤╤┘
